11111111115111111111
10000000010000000001
10111111111110111111
10000000000000100001
10111111111101101111
10000000100101000001
11011111101101011101
10001000101111000101
11101010101101111101
10001010100001000001
10111010101111011111
10000010100001000001
11111110101101111101
10000000001100000001
10111111111111111101
10111100000100000001
10001101110101111101
10101001110101000101
10100011110000110001
11111111119111111111