11111111115111111111
10001000110111000101
10100010010101010101
11101111110101010101
10001100010000010101
10100101010111110001
10111101010101010111
10100101010101000001
10001101000101110101
10010101111100010101
11010000000001100001
10010111110111101111
10100000000000000101
10101111101111111101
10101000100000000001
10101011110111111101
10100000000000000101
10111111110111111101
10000000000000000001
11111111119111111111