11111111115111111111
11000000000111110001
10111111110000000101
10111100011110111101
10111101011110100001
10000001011110111011
11111111011110110011
10100000011110111111
10111111110110000111
10000000110111110111
10111110000111110111
10110111111111110111
10100000010000000111
10111011110111111111
10000011110000000001
10111011110111111101
10111111110110110101
10000000000110000001
11111101110111110111
11111111119111111111